{
    "maxChange" : 7,
    "colors" : ["#0000FF", "#FF0000", "#FFFF00", "#00FF00"],
    "target": 1,
    "data": [
        1,  0,  0,  0,  3, -1,  1,  0,  3,  1, 
        1,  0, -1,  1, -1,  1,  1, -1,  0, -1,
        -1, -1,  1,  2,  2,  0,  2,  3,  1,  1,
        1,  0, -1,  2,  1,  0,  0,  3,  3,  1, 
        2,  3,  3,  3,  3, -1,  0,  2,  2,  3,
        2,  1,  1, -1,  1,  1,  2,  3,  3, -1, 
        3,  1, -1, -1,  2,  2, -1,  0,  0,  1, 
        2,  2,  2, -1, -1,  3, -1, -1,  1,  1
    ],
    "rows": 8,
    "columns": 10
}