{
    "maxChange" : 3,
    "colors" : ["#0000FF", "#FF0000", "#FFFF00", "#00FF00"],
    "target": 3,
    "data": [
        1, 1, 1, 1, 1, 0, 0, 0, 0, 0, 
        1, 0, 0, 0, 1, 0, 3, 3, 3, 3,
        1, 0, 0, 0, 1, 0, 3, 0, 0, 3,
        1, 0, 2, 2, 2, 2, 2, 2, 2, 3, 
        1, 1, 1, 1, 1, 0, 3, 3, 3, 3,
        0, 0, 2, 0, 0, 0, 0, 0, 2, 0, 
        0, 0, 2, 0, 0, 0, 0, 0, 2, 0, 
        0, 0, 2, 2, 2, 2, 2, 2, 2, 0
    ],
    "rows": 8,
    "columns": 10
}