{
    "maxChange" : 4,
    "colors" : ["#0000FF", "#FF0000", "#FFFF00", "#00FF00"],
    "target": 2,
    "data": [
        2,  2,  2,  2,  3,  3, 3, 3, 1, -1, 
        1,  1,  1,  0,  0,  0, 0, 3, 1, -1,
        1,  2,  1,  2,  3,  2, 2, 3, 1, -1,
        1, -1,  1, -1,  3, -1, 2, 3, 1, -1, 
        1, -1,  1,  2,  3, -1, 3, 3, 1, -1,
        1, -1,  1,  2,  2, -1, 2, 2, 2, -1, 
        1, -1, -1, -1, -1, -1, 0, 0, 2,  2, 
        1,  1,  1,  0,  0,  0, 0, 0, 2,  2
    ],
    "rows": 8,
    "columns": 10
}