{
    "maxChange" : 3,
    "colors" : ["#0F00FF", "#FF00F0", "#FFFF00", "#00FF00"],
    "target": 2,
    "data": [
        2, 1, 1, 0, 2, 2, 2, 2, 0, 2, 
        2, 1, 1, 0, 2, 2, 2, 2, 0, 2,
        3, 3, 3, 3, 3, 3, 3, 3, 3, 3,
        2, 1, 1, 0, 3, 3, 3, 3, 0, 2, 
        2, 1, 1, 0, 2, 3, 3, 3, 0, 2,
        2, 1, 1, 0, 2, 2, 3, 3, 0, 2, 
        2, 1, 1, 0, 2, 2, 2, 3, 0, 2, 
        2, 1, 1, 0, 2, 2, 2, 2, 0, 2
    ],
    "rows": 8,
    "columns": 10
}