{
    "maxChange" : 5,
    "colors" : ["#0000FF", "#FF0000", "#FFFF00", "#00FF00"],
    "target": 2,
    "data": [
        1,  1,  0,  1,  1,  1,  3,  3,  3,  2, 
        1, -1, -1, -1, -1,  1,  0,  0,  0,  0,
        3,  3,  3,  3,  3,  3,  3,  3, -1, -1,
        3,  3,  0,  0, -1, -1,  1,  1,  1, -1, 
        3,  3,  3,  3,  3,  3,  3,  3,  3, -1,
        3,  3,  3,  1,  1,  1,  0,  0,  1,  1, 
        3,  0,  0, -1,  0,  1, -1, -1, -1,  1, 
        2,  1,  1,  3,  1,  1,  0,  1,  0,  1
    ],
    "rows": 8,
    "columns": 10
}