{
    "maxChange" : 3,
    "colors" : ["#0F00FF", "#FF00F0", "#FFFF00", "#00FF00"],
    "target": 0,
    "data": [
        2, 2, 2, 2, 2, 2, 2, 2, 2, 2, 
        2, 1, 1, 1, 1, 1, 1, 1, 1, 2,
        2, 1, 3, 3, 3, 3, 3, 3, 1, 2,
        2, 1, 3, 0, 0, 0, 0, 3, 1, 2, 
        2, 1, 3, 0, 0, 0, 0, 3, 1, 2,
        2, 1, 3, 3, 3, 3, 3, 3, 1, 2, 
        2, 1, 1, 1, 1, 1, 1, 1, 1, 2, 
        2, 2, 2, 2, 2, 2, 2, 2, 2, 2
    ],
    "rows": 8,
    "columns": 10
}